16 8
0 0 0 0 4 4 4 4 4 2 2 2 2 1 1 1
0 0 0 0 4 4 4 4 4 2 2 2 2 1 1 1
0 0 0 0 4 4 4 4 4 3 3 3 3 1 1 1
0 4 4 4 4 4 3 3 3 3 2 2 2 2 1 1
0 4 4 4 4 4 3 3 3 3 2 2 2 2 1 1
0 0 0 0 3 3 3 3 3 3 4 4 4 4 4 4
0 0 0 0 3 3 3 3 3 3 4 4 4 4 4 4
0 0 0 0 3 3 3 3 3 3 4 4 4 4 4 4
